BBBBBBBBBBBBBBBBBBBBBBB
B!!!!!!!!!!!!!!!!!!!!!B
B!BBBBBB!BBBBB!BBBBBB!B
B!!!!!!!!     !!!!!!!!B
BBB!BBBB!BB BB!BBBB!BBB
B!!!B!!!!B G B!!!!B!!!B
B!BBB!BB!BBBBB!BB!BBB!B
B!!!!!!B!!!P!!!B!!!!!!B
B!BBBB!!!BB!BB!!!BBBB!B
B!!!!!!BBBB!BBBB!!!!!!B
B!BBBB!!!!B!B!!!!BBBB!B
B!!!!!!BB!!!!!BB!!!!!!B
BBBBBBBBBBBBBBBBBBBBBBB
