BBBBBBBBBBBBBBBBBBBBBBB
BFFFFFFFFFFFFFFFFFFFFFB
BFBBBBBBFBBBBBFBBBBBBFB
BFFFFFFFF     FFFFFFFFB
BBBFBB BBBB BBBB BBFBBB
BFFFBFFB   G   BFFBFFFB
BFBBB BB G G G BB BBBFB
B      BBBBBBBBB      B
BFBBBB     P     BBBBFB
B      BBBB BBBB      B
BFBBBB    B B    BBBBFB
BFFFFFFBBFFFFFBBFFFFFFB
BBBBBBBBBBBBBBBBBBBBBBB
