BBBBBBBBBBBBBBBBBBBBBBB
B                     B
B BBBBBB BBBBB BBBBBB B
B                     B
BBB BB BBBB BBBB BB BBB
B   B  B   G   B  B   B
B BBB BB G G G BB BBB B
B      BBBBBBBBB      B
B BBBB           BBBB B
B      BBBB BBBB      B
B BBBB    B B    BBBB B
B      BB     BB      B
BBBBBBBBBBBBBBBBBBBBBBB
