BBBBBBBBBBBBBBBBBBBBBBB
BFFFFFFFFFFFFFFFFFFFFFB
BFBBBBBBFBBBBBFBBBBBBFB
BFFFFFFFF     FFFFFFFFB
BBBFBB BBBB BBBBFBBFBBB
BFFFBFFB   G   BFFBFFFB
BFBBBFBB G G G BBFBBBFB
BFFFFFFBBBBBBBBBFFFFFFB
BFBBBBFFFFFPFFFFFBBBBFB
BFFFFFFBBBBFBBBBFFFFFFB
BFBBBBFFFFBFBFFFFBBBBFB
BFFFFFFBBFFFFFBBFFFFFFB
BBBBBBBBBBBBBBBBBBBBBBB
