BBBBBBBBBBBBBBBBBBBBBBB
B!!!!!!!!!!!!!!!!!!!!!B
B!BB!BBB!BBBBB!BBB!BB!B
B!!!!!!!!     !!!!!!!!B
BBB!BBBB!BB BB!BBBB!BBB
B!!!B!!!!B G B!!!!B!!!B
B!BBB!BB!BBBBB!BB!BBB!B
B!!!!!!B!!!P!!!B!!!!!!B
B!BBBB!!!BB!BB!!!BBBB!B
B!!!!!!B!!B!B!!B!!!!!!B
B!BBBB!BB!B!B!BB!BBBB!B
B!!!!!!!!!!!!!!!!!!!!!B
BBBBBBBBBBBBBBBBBBBBBBB
